1111111111111111111111111
1000000000110000000000001
1011000001110000C00000001
1001000000000000000000001
1111111110110000011100001
1000000000110000011101111
1111011111111101110000001
1111011111111101110101001
1100000011010101110000001
10000C0P000E00001100P0001
10000P0000000000110101001
1100000111010101111101111
1111111111111111111111111
1111111111 11111111111111