1111111111111111111111111
1000000000110000000000001
101100000111000000C000001
1001000000000000000000001
1111111110110000011100001
1000000000110000011101111
1111011111111101110000001
1111011111111101110101001
1100000011010101110000001
1000C0000000000011000P001
1000000000000000110101001
1100000111010101111101111
1111111111111111111111111
1111111111111111111111111